





        SO ./path_to_the_so_texture   
WE ./path_to_the_we_texture     

EA ./path_to_the_ea_texture  
    NO ./img/file  
F               220, 10,200
C       255,30,0
   
     
          
         
          
111111111111111111111 111
        1111111111111111111111111  
        1000000000110000000000000001
        101100000111000000000001 
        10010000000000N0000000001
1111111110110000011111100000000001    
10000000001100000111011111111111           
1111111111111111111111111 111111111
